R 500 400
NO ./assets/mycub/floor.xpm
SO ./assets/mycub/metal.xpm
WE ./assets/mycub/wall_1.xpm
EA ./assets/mycub/wall_2.xpm
S ./assets/mycub/enemy.xpm
C ./assets/mycub/floor_1.xpm
F ./assets/mycub/floor_1.xpm

1111111111111111111111111111111111111111111111111111111111111111111111111111111111111111
1000011100001110000100000000200000000010000000002000001100000110000100000000000020000001
1000000000S00000000100000000020000010010000110011000001111111011111000000000020000000001
1000000000000000000101111111011111010010000110011000001000001000000101010101010101010101
1000011100001110000100100020010000010000000011110000001111101111110100000000000000000001
1000011100001110000111100000010020010010000000000000001000000000000101010101010101010101
1000011100001110000100000000010000010011101111111111111001111111111100000000200000000001
1000000000000000000101111111111111110010000000000000001001000000000101010101010101010101
1000000000200000000111000000002000010010011010000000001020000000000101010101010101010101
1000000000000000000111000000000000010011111011111111111001000000000100000000200000000001
1111111110011111111111111111110111110010001011000100001001000000000101010101010101010101
1000000000000000000000000000000200000010000000010100001001111111111100000000000000000001
1000000000000020000000000000000000000011111111011101111201000000000101010101010101010101
1001111110011111111111110011110011111100000000020000001000000000000100002000000000000001
1001000000010000010000000001110011111100111111111111111001000000000100000000000200000001
1001000000010010010000000001000010000000100000010020000001111111111111111111100111111111
1111001111110010010001111111010010110100100000010000000001000000001000000000100100000001
1000000001000010010000000001010010110100000200010011101111011111101000020000100101111111
1000000001000010010000000001010010000100100000010010000001000111100000000000100100000001
1001111001111110011111110001110011111100111111110010020001110111101111111111100111111101
1000000200000002000000000000000000000000020000000010000010100001000000000000001002000001
1000000000000000000000000002000000000000000000000011111111011110111111110111100101111111
1111111111111111001111111111110011111100111111111110000001000000000000000000100100000001
1000000000001001001100000000010010000100101000100010111101111011100010000020100111111101
1000020000001000001000000111110010000100100010001010000000010000100010000000100100000001
1002000000011001001100000000000010000100111111111011110111110000100010011111100100020011
1000000000000001001000000111110010000100000000002000000000010000100010000000000100000001
1111111111111111001100000000010011110100111111011111111111011110100011111011111110111101
1001000100010001201111111101010000000100100000000200000000010010100000000200000000000001
1000000000000000001000000001010011111100111111111111111111010110111101101011111111111111
1001000100010001001011111101010000000000001001000100010000010110000000001011111111111111
1000002000000001001010000101011111111100101101010101010111010111111011111002000000000001
1001000100010001001000100101000000000000100000010001000101010000000000001001001001001001
1000000000000001001111111101111111111100111111111011111101011111101111101001001001001001
1001000100010001000000000000000000200000000000200000000001000000000200001000000200000001
1111111111111111111111111111111111111111111111111111111111111111111111111111111111111111