C 12, 123 ,   123
WE ./assets/mycub/wall_2.xpm
NO ./assets/mycub/floor.xpm
SO ./assets/mycub/wall_1.xpm
EA     ./assets/mycub/wall_2.xpm
S ./assets/mycub/enemy.xpm
F ./assets/mycub/floor_1.xpm
R 800                      500



111111111111   111
10000N000001   121
1000000000001  111
1000000000001
1000000000011
10000000001
100000000011   
10000000001
1010100001
111111111111
         
111111111111   111
100000000021   121
1000000000001  111
1000000000001
1000000000011
10000000001
100000000011   
10000000001
1012100001
1111111111 
